wwwwwwwwwwwwwwwwwwwwwwwwwwwwwwwwwwwwwwwwwwwwwwwwwwwwwwwwwwwwwwwwwwww
www                                                              www
www                                                              www
www                                                              www
www                                                           G  www
www                                                       fffffffwww
www                                                              www
www                                                              www
www                                                              www
www                                                              www
www                                                              www
www                                                              www
www                                                              www
www                                                              www
www                                                              www
www                                                              www
www                                                              www
www                                                              www
www                                                              www
www                                                              www
www                                                              www
www                                                              www
www                                                              www
www                                                              www
www                                                              www
www                                                              www
www                                                              www
www                                                              www
www                                                              www
www                                                        wwwwwwwww
www                                                       T    Cwwww
www                                                       ffffffwwww
www                                                      f       www
www                                              T      f        www
www                                            fffff  ff         www
www   fffffff                             T ff      ff         T www
www  fwwwwwww                           ffff  f              ffffwww
wwwf                            T fffff        fffff T      f    www
wwwwfff         f f    $  ffffffffwwwwwf T          fff    f     www
wwwwwwwf    ffffw wfffffffwwwwwwwww   wwff             ffff      www
www      fffwwwww wwwwwwwww            wwwffffffff T             www
www     fwwww                            wwwwwwwwwfff            www
wwwfffffww        T                              wwwwffffff     Cwww
wwwwwwwww      f fff                                wwwwwwwf  fffwww
www           fw wwwfff                                     Bfwwwwww
www          fww wwwwwwffT              WT              T fffwwwwwww
www      T  fwww wwwwwwwwf BA R        ffff             ffwwwwwwwwww
www    Bffffwwww wwwwwwwwwfffffRTWAW ffwwwwfff         fwwwwwwwwwwww
wwwTsRffwwwwwwww wwwwwwwwwwwwwwffffffwwwwwwwwwf  RT AAfwwwwwwwwwwwww
wwwfffwwwwwwwwww wwwwwwwwwwwwwwwwwwwwwwwwwwwwwwfffffffwwwwwwwwwwwwww
wwwgggggggggggggggggggggggggggggggggggggggggggggggggggggggggggggggww