wwwwwwwwwwwwwwwwwwwwwwwwwwwwwwwwwwwwwwwwwwwwwwwwwwwwwwwww
w+                                                     +w
w+                                                     +w
w+                                                     +w
w+                                                     +w
w+                                                     +w
w+                                                     +w
w+                                                     +w
w+                                                     +w
w+                                                     +w
w+                                                     +w
w+                                                     +w
w+                                                     +w
w+                                                     +w
w+                                                     +w
s                                                      +w
w+                                                     +w
w+                                                     +w
w+                                                     +w
w+                                                     +w
w+                                                     +w
w+                                                     +w
w+                                                     +w
w+                                                     +w
w+                                                     +w
w+                                                     +w
w+                                                     +w
w+            1   1  1  1    2        2        3       +w
wwwwwwwwwwwwwwwwwwwwwwwwwwwwwwwwwwwwwwwwwwwwwwwwwwwwwwwww